0100010000010011101001100000111010110101101000000011000110101111010001100011011000011111100110100111
0111010110001010010000001000100111001001000110011001101110011011110001000110101000101110010001010111
1111101101011001110100011110000101010100100000111001010011111111110000000010001101001110001101101011
0000000011010111000010110110011101110100011010011111000010011110010001010110101111011100000100110011
1100011010011001000110110000101101001010100101000110011101001000100011100110011000111010001110101100
1100100111100111010011111010110001111100000000111011011110101111101111110001100101100011000100000111
0001101101010101110011110101110100000110001011011101011101101110000001111010101111111110010110101000
1111111100110010011010001010011000011110101010010011001000111010001110000111111111110000100010011110
0010110000101001010111010110011100111101100110100000001100010111110010100101011111011110001101111111
1111011111110001100010011001000010111011001111111010111101001110110110011011001001001010011111011100
0111101010110000011000100011111100100111110111110110101111011101110100011010101101011011010011010000
1001010011101001000111011011101010101001101100010011100001101001101101111001101000110010001011110100
0000010010111101011101001001111000000111100101011010111110111010110011111111101010010011011110010110
0110111010000000000001011000100000101101010011001111101000001011011100001000000011111100100001010001
0001101111000110011000111011011100000111011110101010000000101000001010111111000001111011010111110101
0110010111100000011100010011110100000111001011010000111010010010101110000011011011001100011101100001
0011010101100110100100010110110000111011011100011111101101000101011001111010001100101100100101111010
0010101110101001011100000000011110100100000101010101110000001100111100101101101100111010110011011011
0111011001110000110101100111111011010001101100101000111010100011101010111111101000010110111000010010
0111101110011111110001001001011011111001011011011100001010010100110110111111111000011110110001011000
0001010101000000100000101000111001100011111100110011101011101000001100011011011010001111101110010100
1011110010011100000000111000011111110010010110001010110001100000000111100101000010101101111100111000
0000011111011110001001010001100010010100101001010101110010100011110011000010100100110100000100110100
0100111101010001010000011010001100101100100110101111000010100100000111110001000100001110001101001011
1010010000000111000011001110111111001101110111011001001101011101101011011011010001100010101110110001
1000010010000110010111001101010000000110010100110001101111101000110100001111100111011110001010000010
1011111111100100111011010100010010111011001000001001001010100110100001000011000110101110101110000010
0101110110110011101101100010001001000101001100010000101011001101000011111101111101001011100111110111
1001101000011011010111000101001101000000010110011110011001110100101000101000010100100101010001001111
1011110001100101000000000101000111001110010011110001001101111101101011100011011100101100111111011110
1000101000101101011001011011111101101011101100110000011101000110011000001100000011010000000110000011
1001111010111111001000100100111101001100001001010001101010100111111001101001110101111111110100111100
0010111101110011110100111100100000111000101111101110000000100011110001011101000110111111000100100000
0001011010001111100000001110001100001011000100101000111000101001010100010010010100111000001111111011
0011000001010010000000111101110011101101001111100011001110111100101010100011100100001111011010010011
0011110010010101000001000110111101111011100010110010101000001100000010011100000011001010011110111110
1010101110101100110001110100011011111100111010011000000011100101001111001001111101110110001001101000
1011010011110110101000101000101000101001101011001100011101101010100110101111000010011011010010101110
1011010010000000110010001001110001101100000111110001111100011000000000110100110110101000011100000010
1110010100011101011111011101001111110000100111110010111000011110011110110101010011001100001000111001
1100100101110001010010100101101001000011010011010100010110001000100100000000011100101000101011001111
1001000110000101101111011100000000110110011001011010000110011011010100111001010110111010111101000011
0000111111110110000001111111111000111111010001101100100110001001111000100001001011100001101100111000
1100010110000111000001110000010101100000101100110011000010010001011011110111100011110011100010010110
1101011011111011010000011011111011011101010101111010000100111100110111001011100011101110110110101010
1101111011101111110101011100001110110100101000101011101111101110011011000100100011000110111010100001
1111000010100010010000101001011000001011000000100110000010000001111011001001000111110101010101001011
1111010000011001101111110000110010001001010100011100000100100100100010101011100100110011111001010001
0110101110110010110010110111000111000100001100111001110100101001111011000001101101110010101100010001
0111000111111110010101010001110011101010000100000011010010011011010011101011000110001111111000000110
0101101011101011111011110010100001001110011011010001010000000111111110001110101111011001010001001010
0011000011000011000110010011000000001010011001010111011000101001100100100110001111010011111001100010
1011011011101110001110100010000011110011011010001001100001111011111010001111100110110010110101111001
0010011000101001101001111110000010101100101001100001000000111010101000000101101000110001110111000101
0110011001010100000001100000000000100011000010111101010111111011111110010111110111100000110100011101
0100110110100000010000101100010111100011000001110101000011010000100100100011111100110100101000011100
0000111110101010101100011110000111000010010111101010011110101011011100011000011101111111100101011000
0110010101110101110011101011010100001010101000011111000000110111011100111100011101100011011110000010
0011101001010001000010101000000010010101111101011000011001000101010101100110001101100100010100001110
1010110101110111010101110001001000011011010110101000111010011001110100111111010001101101001100101101
1101111001000101100101001101100000001101011011011111010000110110100010011100110001110010111110100001
0000101100000111010001110110101111110100010011001001111110001011111011011101001011111001010010111010
0011010110000010001101001000000110001111111001011110011101110000010001001111010101100001111001110011
1110000010111000111100010111000110010100110110001010001011010111000101000011100011100000111101101000
0001010100011001000001000000100100101101110010000110001000000001101010000100101100001011000111001011
0011010000001101011110101011000101010110110010100010001000110101001001110001111010101010101111101011
1010001000011111011100110000011010100100110101101010001001010110000111101100110111100001011110001110
0101011000111100011111100101001010101010111110100111000001000001000001111000111010001011000000110001
1100000001111100000010100011010010011010100110011100010000100010010110000010111101000011110111011010
1010111110010100010000110111001101000000111000101110111111100100111011101010000110101101101011000111
1100000110010111001001101110110010101111001011101011111000101110100101011010101001010000000110010010
1100110111111110110010001001100111010101011111100010010000110110001111100000001001000100111001110110
0111011100101010111100100001001010101011100110101101001010100011101101101001111100101001000100010000
0011110100001101100110001100010010000001100111100011100001001011100110000100011010110011101110000000
1000110001011011101010011100000101011011001010100001000001001100101110110011011000000000100000001100
1111110010100001100100100101110100000100010100101000011010101001010110011111101110101111011010011111
0101011101100100011011101011100110100110010111111001001101000000011111001011110101111111011101010001
1100010010011010110001001011100110011100110010100001111010001101110010000001011101100101011000100110
1100111101100111101101110010111010101000111001100111011011001001110010111001011101010010000101110100
0011001111001111001110110010101001100010010010010010100010011111000000011100110000100011011110111010
1010111100111100101010010100100100010100101010001001001101010000001010011100010100110001000101001111
0010000111000000000100110010000001001100011110111011100011010110101010100111010100001111011011111000
1110101000001000011101001011100111100010110101010001001010000001110110011111111010001000001010001100
0010110000000110101111101111110000011100010010111010000100011101001111010011110001010001101010100111
1000001100000001011010011111111011011000000101110100101001011100010001000110110011100001011101101001
0111111001001111001001110011010000011010010001010010010100001101001000101100000110010101011101001110
1100110001000111111010100111110101100101011100001010100001101000111110010100001101000001011100010011
1100110100101110000100000110100000111110110111110111110100111010111111110001000010000111111010101100
0111001000101001111100111101111100010100110001000011000100000100010000010100000101110010111101110001
0100100001010000000100000100111001110111110111010011011001001000000101001100011110001001000011001101
0010001110001010010100100001011101010011101110110110010000010111110011110100111011111000011001001000
0100101011111110000011001000010001100010101101110000010001011111011100001110101100100000010011011111
1101110110011010011010111110101000010011001110011011100111110100011000111011000010000011001110011101
0101111101011110010000101000111101111001011100010100011110101111010011110000101100101001000010101000
1101100100101011010111000111111000010111101110111001111100000010001000111110001101000100010110001100
0001110001001100110001000111001001100000010001010100111000111110001011000010100101101100001110000010
1101101101000110000101100001100101111110100101011000001100101001001011101100101011100001101101010100
1101000000101101010000001110100111001101000100100010001100010111011000111110101101000000010100001111
0011101110000010101010100001001010100100100001000111100011000110111010000101111110110110010011011101
0110101111011101111010100011011111111110010010111100000001011010101100011111101011000010100011011111
